##############
#P        D D#
#   C  C  C  #
#  D   CD    #
#            #
##############