OOO#####OOO
####   #OOO
#  #C  ####
# CC      #
#P  #C C# #
### #   # #
O#  ##### #
O#  DDDDD #
O##########