OOOOOO######
OOOOOO#    #
OOOOOO#D   #
OOOOOO#D   #
OOOOOO# C  #
OOOOOO# P  #
#######    #
#   C      #
#  C      D#
############