#######OOO#######OOO
#  D  #OOO# DC  #OOO
#     ##### ### ####
####       C C   DD#
####    P    C C DD#
#  C  ##############
#D  C #OOOOOOOOOOOOO
#######OOOOOOOOOOOOO