OO#####O
###   #O
#DPC  #O
### CD#O
#D##C #O
# ##D ##
#C  CCD#
#   D  #
######## 