OOOO#####OOOOOOOOOO
OOOO#   #OOOOOOOOOO
OOOO#C C#OOOOOOOOOO
OO###   ##OOOOOOOOO
OO#   C  #OOOOOOOOO
### # ## #OOO######
#   #C## #####  DD#
# CP C          DD#   
##### ### # ##  DD#
OOOO#     #########
OOOO#######OOOOOOOO
OOOOOOOOOOOOOOOOOOO