########
#  #  P#
#   C# #
#DCC D #
# #D#C##
#  D  #O
#######O