OOOOOO####
OOOO###DD#
OOOO# PDD#
OOOO# CDD#
######  ##
#      ###
## C C C #
O# CC# # #
O#   #   #
O#########