##############OO
#    ###   #D#OO
# C     C  #D#OO
# C  # #   #D##O
## ### ##C##DD##
# C  #C#   # PD#
#  C C   C  DDD#
# C  #C#   #DD #
## ### ## ##DD##
#  D # # C #D##O
# DD     C #D#OO
#    ###   #D#OO
##############OO